0 0 0 0 0 0 0 0 0 0 0 0 0 0 0 0 0 0 0 0 0 0 0 0 0 0 0 0 0 0 0
0 1 1 2 1 1 1 2 2 1 2 1 1 1 1 2 2 1 2 2 1 2 1 2 5 1 1 1 1 1 0
0 1 0 1 0 1 0 2 0 2 0 1 0 1 0 1 0 1 0 1 0 1 0 4 0 1 0 2 0 1 0
0 2 1 3 1 1 1 1 2 4 2 2 2 1 2 1 1 2 2 2 1 5 1 1 2 1 9 2 1 1 0
0 1 0 1 0 1 0 1 0 1 0 2 0 2 0 1 0 2 0 1 0 1 0 1 0 1 0 1 0 1 0
0 1 1 1 1 1 1 1 1 2 2 1 2 1 2 2 1 2 1 1 1 1 1 1 1 1 2 1 1 1 0
0 1 0 1 0 1 0 1 0 1 0 2 0 2 0 1 0 5 0 1 0 1 0 1 0 1 0 1 0 1 0
0 2 1 1 2 1 1 1 2 2 1 1 1 2 1 2 1 1 2 2 1 1 2 1 1 1 9 2 1 1 0
0 1 0 1 0 1 0 4 0 1 0 2 0 1 0 1 0 2 0 1 0 1 0 1 2 1 0 1 0 1 0
0 1 1 1 1 1 2 1 2 1 1 1 2 2 1 1 1 1 1 1 2 1 2 4 1 1 1 1 1 1 0
0 1 0 2 0 1 0 2 0 1 0 2 0 1 0 2 0 1 0 2 0 1 0 2 0 1 0 1 0 1 0
0 1 2 2 2 1 1 2 1 1 1 1 1 1 4 2 1 1 1 2 1 5 1 2 1 2 2 1 1 1 0
0 0 0 0 0 0 0 0 0 0 0 0 0 0 0 0 0 0 0 0 0 0 0 0 0 0 0 0 0 0 0